 0  0  0  0  0  0  0  8  0  0  0  0  0  0
 0  0  0  0  0  0  0  0  0  0  0  0  0  0
 0  0  0  0  0  4  0  0  0  0  0 16  0  0
 0  0  0  0  0  4  0  0  0 16  0  0  0  0
16  0  0  4  0  0  0  0  0  0  0  4  4  4
 0  0  0  0  0  0  0  0  0  0  0  0  0  0
 0  0  0  0  0  0  4  0  0  0  0  0  0  0
 0  4  0  0  0  0  0  0  0  0  0  0  0  0
 0  0  0  0  0  0  0  0  0  0  4  0  0  0
 0  0  0  8  0  0  0  0  0  0  0  0  0  0
 0  0  0  0  0  8  0  0  0  0  0  0  0  0
 0  0  0  0  0  0  8  0  0  0  0  4  4  4
 0  0  0  4  0  0  0  0  0  0  0  0  8  8
 0  0  0  0  0  0  0  0  0  2  1  4  4  4