0 0 0 0 0 0 0 8 8 8 8 8 0 0 
0 0 0 0 0 0 0 8 8 0 0 8 8 0 
0 0 0 0 0 0 0 8 8 8 8 8 0 0 
0 0 0 0 4 8 8 8 8 8 8 0 0 0 
0 0 0 4 0 0 0 0 0 0 8 0 0 0 
0 0 0 0 0 0 4 4 4 0 8 0 0 0 
0 0 4 0 0 0 4 4 0 0 8 0 0 0 
0 0 4 1 0 0 4 4 0 0 8 0 0 0 
0 4 0 0 0 0 4 4 0 0 8 8 0 0 
0 0 4 0 0 0 4 0 0 0 0 8 0 0 
0 0 4 4 4 4 4 4 4 0 8 8 0 0 
0 0 0 0 0 0 0 0 0 8 8 0 0 0 
0 0 0 0 0 2 0 0 0 0 0 0 0 0 
0 0 0 0 0 0 0 0 0 0 0 0 0 0 