8 8 8 8 8 4 8 8 4 8 8 4 8 8 
8 8 8 8 8 8 8 8 8 1 8 4 8 8 
4 8 8 8 8 8 8 8 8 4 8 8 8 4 
8 8 8 8 8 8 8 8 8 8 8 8 8 8 
8 8 8 4 8 8 8 8 8 4 8 8 8 8 
8 8 8 8 8 8 8 8 8 8 8 4 8 8 
8 4 8 8 4 4 8 8 8 4 8 8 8 8 
8 8 8 8 2 8 8 8 8 8 8 8 8 8 
8 8 8 8 4 8 8 8 8 4 8 4 8 8 
8 4 8 8 8 8 8 8 8 8 8 8 4 8 
8 8 8 8 8 8 4 8 8 8 8 8 8 4 
4 8 8 8 8 8 8 8 4 8 8 8 8 8 
8 8 8 8 8 4 8 8 8 8 8 8 8 8 
8 8 8 4 8 8 8 8 8 4 4 8 8 8 