4  4  4  4  4  4  4  4  4  4  4  4  4  4  4  4
4  8  8  8  8  8  8  8  8  8  8  8  8  8  8  4
4  8  8  8  8  8  8  8  8  8  8  8  8  8  8  4
4  8  8  8  8  8  8  8  8  8  8  8  8  8  8  4
4  8  8  8  8  8  8  8  8  8  8  8  8  8  8  4
4  8  8  8  8  8  8  8  8  8  8  8  8  8  8  4
4  8  8  8  8  8  8  8  8  8  8  8  8  8  8  4
4  8  8  8  8  8  8  8  8  8  8  8  8  8  8  4
4  8  8  8  8  8  8  8  8  8  8  8  8  8  8  4
4  8  8  8  8  8  8  8  8  8  8  8  8  8  8  4
4  8  8  8  8  8  8  8  8  8  8  8  8  8  8  4
4  8  8  8  8  8  8  8  8  8  8  8  8  8  8  4
4  8  8  8  8  8  8  8  8  8  8  8  8  8  8  4
4  8  8  8  8  8  8  8  8  8  8  8  8  8  8  4
4  8  8  8  8  8  8  8  8  8  8  8  8  8  1  4
4  4  4  4  4  4  4  4  4  4  4  4  4  4  4  4