0 0 0 0 0 0 0 0 0 4 0 0 0 0 
0 4 0 0 0 4 0 4 0 0 0 0 0 0 
4 0 4 0 0 4 0 0 0 0 0 0 0 0 
0 0 0 4 0 0 0 4 0 0 0 0 0 4 
0 0 0 0 8 0 0 0 0 0 0 4 0 0 
0 0 0 0 0 8 0 0 0 0 0 4 0 0 
0 0 0 0 0 0 0 0 0 2 0 0 0 0 
0 0 4 4 0 0 0 0 0 8 0 8 0 0 
4 0 0 0 0 0 0 4 0 0 4 0 4 0 
0 4 0 0 0 0 0 0 4 0 0 8 0 0 
0 8 0 0 0 0 1 4 0 4 4 0 0 0 
0 0 4 0 0 0 0 0 0 0 0 4 0 0 
0 0 0 0 0 0 0 8 4 0 0 0 0 0 
0 0 0 8 0 0 0 0 4 0 0 0 0 4 