0 0 0 0 0 0 0 0 0 8 0 0 0 1 
0 0 4 0 0 4 4 0 0 8 0 0 16 8 
0 4 0 0 4 0 0 0 0 8 0 0 16 8 
0 0 0 4 0 0 0 0 0 8 0 0 16 8 
0 4 0 0 0 4 0 4 0 0 0 0 16 8 
0 4 0 0 0 0 0 4 4 0 0 0 16 8 
0 0 4 0 0 0 4 4 0 0 0 0 16 8 
0 0 0 0 4 4 0 0 0 0 0 0 16 8 
0 8 0 0 0 0 0 0 0 8 0 0 16 8 
0 16 16 16 16 0 0 0 0 0 0 0 16 8 
0 0 0 0 0 0 0 0 0 0 0 0 16 8 
0 0 0 0 0 0 0 0 0 0 0 0 16 8 
0 16 16 16 16 16 16 16 16 16 16 16 16 8 
2 8 8 8 8 8 8 8 8 8 8 8 8 8 